Cid

1

var board = [
    [ 23, 23, 23, 23, 23, 23, 23 ],
    [ 23, 23, 23, 23, 23, 23, 23 ],
    [ 23, 23, 45, 45, 45, 23, 23 ],
    [ 23, 23, 11, 5, 19, 23, 23 ],
    [ 23, 23, 46, 35, 47, 23, 23 ],
    [ 23, 23, 23, 23, 23, 23, 23 ],
    [ 23, 23, 23, 23, 23, 23, 23 ]
];

2

var board = [
    [ 23, 23, 23, 23, 23, 23, 23 ],
    [ 23, 23, 23, 23, 23, 23, 45 ],
    [ 23, 23, 45, 45, 45, 45, 19 ],
    [ 23, 23, 11, 5, 5, 5, 17 ],
    [ 23, 23, 46, 35, 35, 35, 35 ],
    [ 23, 23, 23, 23, 23, 23, 23 ],
    [ 23, 23, 23, 23, 23, 23, 23 ]
];

3

var board = [
    [ 23, 23, 23, 23, 23, 23, 23 ],
    [ 23, 45, 45, 23, 45, 45, 23 ],
    [ 23, 5, 11, 23, 19, 5, 23 ],
    [ 23, 2, 46, 23, 47, 2, 23 ],
    [ 23, 2, 45, 45, 45, 2, 23 ],
    [ 23, 2, 5, 5, 5, 2, 23 ],
    [ 23, 35, 35, 35, 35, 35, 23 ]
];

4

var board = [
    [ 20, 0, 22, 23, 9, 9, 10 ],
    [ 21, 1, 3, 23, 2, 2, 31 ],
    [ 2, 2, 2, 23, 2, 41, 8 ],
    [ 35, 35, 2, 27, 2, 32, 35 ],
    [ 36, 36, 2, 6, 2, 7, 36 ],
    [ 23, 23, 35, 35, 2, 38, 23 ],
    [ 23, 23, 36, 36, 34, 36, 23 ]
];

#########################################################

Refikii

1

var board = [
    [ 23, 23, 45, 23, 23, 23, 23 ],
    [ 23, 23, 11, 23, 23, 23, 23 ],
    [ 23, 23, 1, 23, 23, 23, 23 ],
    [ 23, 23, 2, 45, 45, 23, 23 ],
    [ 23, 23, 2, 5, 19, 23, 23 ],
    [ 23, 23, 35, 35, 47, 23, 23 ],
    [ 23, 23, 23, 23, 23, 23, 23 ]
];

2

var board = [
    [ 23, 45, 23, 23, 23, 23, 23 ],
    [ 23, 11, 45, 23, 23, 23, 23 ],
    [ 23, 1, 5, 45, 23, 45, 23 ],
    [ 23, 35, 2, 5, 45, 19, 23 ],
    [ 23, 23, 35, 2, 5, 17, 23 ],
    [ 23, 23, 23, 35, 35, 35, 23 ],
    [ 23, 23, 23, 23, 23, 23, 23 ]
];

3

var board = [
    [ 23, 23, 23, 23, 5, 19, 23 ],
    [ 23, 45, 45, 23, 2, 17, 23 ],
    [ 23, 5, 11, 23, 2, 25, 23 ],
    [ 23, 2, 46, 23, 2, 5, 23 ],
    [ 23, 2, 45, 45, 34, 2, 23 ],
    [ 23, 2, 5, 5, 5, 2, 23 ],
    [ 23, 35, 35, 35, 35, 35, 23 ]
];

4

var board = [
  [ 20, 0, 22, 23, 30, 9, 10],
  [ 21, 1, 3, 23, 29, 2, 31],
  [ 2, 2, 2, 23, 28, 2, 8],
  [ 2, 40, 25, 27, 26, 41, 2],
  [ 2, 24, 5, 6, 5, 32, 2],
  [ 2, 4, 2, 35, 2, 7, 2],
  [33, 34, 2, 36, 37, 38, 39]
];
